. . . . . . . . . . . . W . . . . . . .
. . . . . . . . . . . . W . W . . . . .
. . . . . . . . . . . . W . W . . . . .
W . W W . . . . . . . . W . W W . W W W
S . . W . . W W W W W w W . W . . W W E
W . W . W . . . . . . . W . W . . W W .
. . . . W . . . . . . . W . W . . W . .
. . . . W . . . . . . . W . W . . . . .
. . . . . W . . . . . . W . W . . . . .
. . . . . . W . . . . . . . W . . . . .